mdh36	TTAACGTTAACGCCGGT	TGGTAACACCAGAGTGACCA
gyrB47	CTGCGCGATAAGCGCGAC	AATACCGTCTTTTTCGGTGGAA
trpA72	CTTTTGCGGCGGGAGTA	GAAATCGCGCCCGCAGT
prophage	TTACTCCGACTATGCGTTCAC	CTTCTTCGCTGGCAACTTCT
rfb_O16	GAAGGTGTTACCACCATCAATG	CAGGATCATTTATGCTGGTACG
rfb_O25b	GAAGGTGTTACCACCATCAATG	ATGCTATTCATTATGCGCAGC
sbmA	GCTGCCTACCGTAAAGAA	CCGTAGGCGGCGTCA
plsB	AGAATTCCGGCGCGTTG	CGCGAGCAGTTAACCG
nupC	TCCCGCAATCGTATGTACACC	ATCCATCATCGCAACGAAC
rmuC	TATCGCGTCGGTGCGTAAC	CCTGCGCTTTGTCGAGAT
kefC	CGCAAATGGGCCGCAGA	GCACTAAACACTTCCCGCA
ybbW	GTTGCGGTCTGGGCA	TCCAGCACGTTCCAGGTG
parC_E84V	GGCGATATTGCCTGTTATGT	TTCGGATCGTCCGGCGCC
fliC_H5	CGTTCAAGCGACGACCGGG	ATGTTACATATCCCGCAGCCGA
fliC_H4	GGCGAAACTGACGGCTGCTG	ACCAACAGTTACCGCCGC
fimH30	GCCAATGGTACCGCTATT	GCTTTAATCGCCACCCCA
fimH35	CTGTAAAACCGCCAATGGTACA	TGACATCACGAGCAGAAACATCG
fimH27	TGGGGCAAAACCTGGTCGTG	TGACATCACGAGCAGAAACATCG
fimH22	TGGGGCAAAACCTGGTCGTG	CAGCTTTAATCGCCACTCCC
fimH41	CTGTAAAACCGCCAATGGTACA	TTTGCCCCACATTCACGGCG
